1111111111111
10010000P00C1
1010011111001
100011E000001
1111111111111
